==o=-------
==o=----##-
oo=o----##-
=ooo---##--
o==o-------
xxxxxx-----
$xxxxx-----
xxx$xx-----
xx$$xx-----
$$xxxx-----
xxx$$x--MWT