==o=------------
==o=----##------
=o=o----##-##---
=o==---##--##---
o==o-----####---
$x$$xx---####---
$x$$xx----------
x$$$xx----------
xx$$xx----------
$$xxxx----------
xxx$$x--MWT-----